"a" = (/turf/grass,/area)
"b" = (/turf/grass,/turf/dirt,/area)
"c" = (/mob/npc/rat,/turf/grass,/area)

(1,1,1) = {"
aaaaaaaaaa
bbbaaabbaa
baaabaabca
cabaacaaaa
aaabaaabaa
baabacaaaa
abcaaababa
aaaabcaaaa
ababbababa
abaaaaaaaa
"}
